apparition	illusion	appearance	ghost
constructive_fraud	fraud	crime	fraud_in_law
photographic_equipment	equipment	instrumentality	camera
encouragement	approval	message	cheering
container	instrumentality	artifact	dish
headdress	clothing	consumer_goods	hat
cushion	padding	artifact	pillow
commercial_enterprise	enterprise	organization	industry
dispatch	departure	act	reshipment
artwork	visual_communication	communication	drawing
eisteddfod	festival	celebration	Royal_National_Eisteddfod
metric_linear_unit	linear_unit	unit_of_measurement	kilometer
desertion	withdrawal	departure	absence_without_leave
time_period	fundamental_quantity	measure	morning
carnivore	placental	mammal	feline
interchange	interaction	action	dealings
code	coding_system	writing	software
coloring_material	material	substance	pigment
induction	introduction	beginning	induction_of_labor
sucker	catostomid	cypriniform_fish	buffalo_fish
table_game	game	activity	table_tennis
opinion	belief	content	judgment
unfriendliness	disposition	nature	hostility
show	entertainment	diversion	Wild_West_Show
whiptail	teiid_lizard	lizard	plateau_striped_whiptail
religious	religious_person	person	monk
physical_property	property	attribute	weight
reconnaissance	intelligence	information_gathering	reconnaissance_in_force
financial_condition	condition	state	wealth
transportation	movement	change	delivery
integer	number	definite_quantity	digit
pyralid	moth	lepidopterous_insect	Mediterranean_flour_moth
snapping_turtle	turtle	chelonian	common_snapping_turtle
beam	light	actinic_radiation	sunbeam
representation	creation	artifact	pieta
transferred_property	possession	relation	loss
conflict	state	attribute	disagreement
acknowledgment	message	communication	apology
agent	representative	negotiator	booker
reproductive_cloning	cloning	biological_research	human_reproductive_cloning
performance	accomplishment	action	overachievement
contradictoriness	opposition	relation	incompatibility
trespass	tort	wrongdoing	trespass_viet_armis
anchor	hook	mechanical_device	mushroom_anchor
spiritual_leader	leader	person	rabbi
domestic_fowl	gallinaceous_bird	bird	turkey
tract	geographical_area	region	breeding_ground
attire	clothing	consumer_goods	costume
projective_test	personality_test	test	Thematic_Apperception_Test
tibialis	skeletal_muscle	muscle	tibialis_anticus
building	structure	artifact	hotel
component	part	object	ingredient
information	message	communication	news
bottlenose_dolphin	dolphin	toothed_whale	Atlantic_bottlenose_dolphin
garter_snake	colubrid_snake	snake	Western_ribbon_snake
internal_organ	organ	body_part	stomach
trouser	garment	clothing	pajama
situation	state	attribute	environment
device	instrumentality	artifact	instrument
tube	conduit	passage	stent
aorta	artery	blood_vessel	abdominal_aorta
line	artifact	whole	cord
path	line	location	direction
philosophy	humanistic_discipline	discipline	logic
beam	piece	part	timber
bench_press	weightlift	bodybuilding	incline_bench_press
poultry	bird	meat	chicken
place_of_worship	building	structure	mosque
discussion	communication	act	dilation
ocean_trip	water_travel	travel	cruise
paper	material	substance	card
originality	ability	cognition	innovativeness
cabbage_butterfly	pierid	butterfly	southern_cabbage_butterfly
ravine	valley	natural_depression	canyon
military_action	group_action	act	war
memory_image	image	representation	memory_picture
art	creation	artifact	gem
electronic_deception	electronic_countermeasures	electronic_warfare	manipulative_electronic_deception
document	writing	written_communication	report
book	publication	work	booklet
escape	running_away	act	exodus
contact_sport	sport	diversion	football
procedure	activity	act	calculation
angular_distance	angle	space	latitude
trip	journey	travel	round_trip
use_immunity	exemption	release	transactional_immunity
wind	weather	atmospheric_phenomenon	breeze
thoroughfare	road	way	street
care	work	activity	treatment
spouse	domestic_partner	person	husband
measuring_instrument	instrument	device	static_tube
body	social_group	group	college
weightlift	bodybuilding	exercise	clean_and_jerk
affair	social_event	event	celebration
natural_science	science	discipline	physics
apparition	illusion	appearance	unidentified_flying_object
homicide	killing	termination	murder
association	organization	social_group	league
success	attainment	accomplishment	winning
shellfish	seafood	food	lobster
fur	animal_skin	animal_product	raccoon
poisonous_plant	plant	organism	poison_ash
medium_of_exchange	standard	system_of_measurement	money
public_transport	conveyance	instrumentality	train
unpleasant_person	unwelcome_person	person	scold
sum	assets	possession	coverage
eye_operation	operation	medical_procedure	laser_trabecular_surgery
tubular_cavity	cavity	structure	throat
bedroom	room	area	motel_room
adult	person	causal_agent	man
childs_game	game	activity	musical_chairs
boat	vessel	craft	police_boat
life	living_thing	whole	wildlife
garment	clothing	consumer_goods	laundry
concession	agreement	speech_act	stipulation
paramyxovirus	myxovirus	animal_virus	respiratory_syncytial_virus
concession	contract	written_agreement	franchise
skin_diving	swimming	water_sport	snorkeling
battleship	warship	military_vehicle	pocket_battleship
film_industry	industry	commercial_enterprise	Bollywood
product	creation	artifact	movie
ejection	banishment	rejection	barring
hairdo	hair	body_covering	haircut
microscopy	research	investigation	dark_ground_illumination
insertion	movement	change	injection
board_game	parlor_game	game	snakes_and_ladders
election	vote	group_action	general_election
people	group	abstraction	population
migration	motion	change	immigration
atmospheric_phenomenon	physical_phenomenon	natural_phenomenon	weather
statement	commercial_document	document	income_statement
physicist	scientist	person	astronomer
rear	side	surface	stern
design	arrangement	structure	layout
imaginary_place	imagination	creativity	spirit_world
activity	act	event	market
army_unit	military_unit	unit	troop
lipid	macromolecule	molecule	oil
jewelry	adornment	decoration	jewel
instrumentality	artifact	whole	container
watch	timepiece	measuring_instrument	pocket_watch
explosive_device	device	instrumentality	bomb
system	group	abstraction	network
demonstration	visual_communication	communication	display
classical_music	music_genre	expressive_style	opera
nucleon	baryon	fermion	proton
hymenopterous_insect	insect	arthropod	bee
national	person	causal_agent	citizen
grass	gramineous_plant	herb	broom_grass
fluid	substance	matter	liquid
weaponry	instrumentality	artifact	hardware
medium_of_exchange	standard	system_of_measurement	money
theater	building	structure	music_hall
kin	social_group	group	folks
building	structure	artifact	theater
vascular_plant	plant	organism	herb
pictorial_representation	representation	activity	photography
roll_of_tobacco	tobacco	drug_of_abuse	cigarette
school	educational_institution	institution	public_school
gymnastic_exercise	exercise	effort	double_leg_circle
dish	nutriment	food	chili
armor	protective_covering	covering	body_armor
schemer	planner	person	angler
flower	angiosperm	spermatophyte	daisy
air_defense	defense	military_action	active_air_defense
score	number	definite_quantity	football_score
geological_formation	object	physical_entity	shore
contest	social_event	event	tournament
grebe	podicipitiform_seabird	seabird	great_crested_grebe
machine	device	instrumentality	computer
hour	clock_time	reading	noon
skeletal_structure	structure	body_part	girdle
edible_fruit	fruit	reproductive_structure	apple
reverse_hang	hang	gymnastic_exercise	piked_reverse_hang
nymphalid	butterfly	lepidopterous_insect	peacock
kitchen_appliance	home_appliance	appliance	stove
celestial_body	natural_object	whole	planet
scientific_theory	theory	explanation	steady_state_theory
scheme	plan_of_action	plan	waiting_game
arenavirus	animal_virus	virus	lymphocytic_choriomeningitis_virus
professional	adult	person	lawyer
female_offspring	child	offspring	daughter
public_knowledge	cognition	psychological_feature	common_knowledge
steering	control	activity	driving
topographic_point	point	location	junction
pleasure	feeling	state	enjoyment
device	instrumentality	artifact	breathing_device
defense	military_action	group_action	biological_warfare_defense
motor_vehicle	self-propelled_vehicle	wheeled_vehicle	car
science	discipline	knowledge_domain	psychology
placental	mammal	vertebrate	carnivore
food	solid	matter	seafood
grass	gramineous_plant	herb	meadowgrass
linear_unit	unit_of_measurement	definite_quantity	mile
forced_landing	aircraft_landing	landing	crash_landing
postulate	proposition	statement	premise
time_period	fundamental_quantity	measure	century
seat	furniture	furnishing	chair
position	attitude	cognition	point_of_view
site	tract	geographical_area	cemetery
supplier	businessperson	capitalist	distributor
operation	medical_procedure	procedure	dilation_and_curettage
circuit_board	printed_circuit	computer_circuit	PC_board
feeling	state	attribute	apathy
condition	state	attribute	danger
environment	situation	state	ecology
monetary_unit	unit_of_measurement	definite_quantity	dollar
angiosperm	spermatophyte	vascular_plant	flower
fog	aerosol	cloud	mist
dance_step	locomotion	motion	moonwalk
computer_architecture	specification	description	neural_network
circumstance	information	cognition	mitigating_circumstance
collection	group	abstraction	galaxy
thrall	bond_servant	slave	serf
marital_status	legal_status	status	marriage
lens	optical_device	device	camera_lens
enclosure	area	structure	dock
squash	vine	vascular_plant	pumpkin
tent_caterpillar	caterpillar	larva	forest_tent_caterpillar
mathematical_statement	statement	message	formula
bird	vertebrate	chordate	parrot
cost	outgo	transferred_property	payment
liquid_body_substance	body_substance	substance	blood
vessel	craft	vehicle	boat
flight	trip	journey	connecting_flight
forest	vegetation	collection	grove
handicraft	arts_and_crafts	art	bookbinding
chamber	enclosure	area	furnace
pension_plan	plan	idea	individual_retirement_account
secretaryship	position	occupation	Secretary_of_the_Interior
feat	accomplishment	action	tour_de_force
chemical	material	substance	restrainer
vegetation	collection	group	forest
logistic_support	support	activity	integrated_logistic_support
push_button	switch	control	mouse_button
toiletry	instrumentality	artifact	lotion
performer	entertainer	person	magician
good	morality	quality	kindness
company	institution	organization	drug_company
extremity	external_body_part	body_part	limb
sovereign	head_of_state	representative	king
creativity	ability	cognition	imagination
administrative_district	district	region	reservation
kind	category	concept	type
prediction	statement	message	prognosis
horizontal_surface	surface	artifact	floor
parent	genitor	progenitor	mother
rehabilitation_program	program	system	vocational_rehabilitation_program
citrus	edible_fruit	fruit	orange
bias	partiality	inclination	racism
rat	rodent	placental	brown_rat
uncreativeness	inability	cognition	unoriginality
herpes_zoster	herpes	animal_virus	herpes_varicella_zoster
skeletal_muscle	muscle	contractile_organ	temporalis_muscle
device	instrumentality	artifact	source_of_illumination
ovum	gamete	reproductive_cell	egg
meal	nutriment	food	breakfast
entrance	arrival	action	registration
reaction	bodily_process	organic_process	galvanic_skin_response
metric_space	mathematical_space	set	Euclidean_space
clothing	consumer_goods	commodity	footwear
reinforcing_stimulus	stimulation	information	positive_reinforcing_stimulus
changeableness	quality	attribute	mutability
squeeze_play	baseball_play	maneuver	safety_squeeze_play
handwear	clothing	consumer_goods	muff
fabric	artifact	whole	linen
backsliding	failure	nonaccomplishment	recidivism
court_game	athletic_game	game	tennis
nerve_cell	somatic_cell	cell	brain_cell
salt	compound	chemical	sodium_carboxymethyl_cellulose
text	matter	writing	lyric
capture	felony	crime	kidnapping
bathing	diversion	activity	sea_bathing
defender	preserver	person	guard
heating_system	utility	facility	panel_heating
building	structure	artifact	restaurant
capital	assets	possession	stock
fish	aquatic_vertebrate	vertebrate	bony_fish
hour	clock_time	reading	sunset
liquor	alcohol	beverage	vodka
waste	activity	act	boondoggle
torture	persecution	maltreatment	sleep_deprivation
covering_material	building_material	artifact	plaster
man	adult	person	stud
pipe	tube	conduit	steam_line
visionary	intellectual	person	forecaster
microwave_spectroscopy	spectroscopy	chemical_analysis	electron_spin_resonance
big_cat	feline	carnivore	jaguar
organization	social_group	group	institution
jewelry	adornment	decoration	necklace
flock	animal_group	biological_group	gaggle
flower	angiosperm	spermatophyte	sunflower
running_away	act	event	elopement
metallic_element	chemical_element	substance	aluminum
thinking	higher_cognitive_process	process	train_of_thought
coordinate_system	arrangement	structure	inertial_reference_frame
footwear	covering	artifact	boot
crayfish	decapod_crustacean	crustacean	Old_World_crayfish
currency	medium_of_exchange	standard	cash
fiction	literary_composition	writing	story
management	social_control	group_action	administration
broadcasting	telecommunication	medium	television
cattle	bovine	bovid	ox
globule	ball	sphere	bubble
great_ape	anthropoid_ape	ape	gorilla
indigo_snake	colubrid_snake	snake	eastern_indigo_snake
connective_tissue	animal_tissue	tissue	marrow
travel	motion	change	journey
dealer	firm	business	car_dealer
bicycle	wheeled_vehicle	container	mountain_bike
motorboat	boat	vessel	launch
emotional_state	emotion	feeling	happiness
bulge	projection	convex_shape	nub
despair	feeling	state	discouragement
courtesy	manner	demeanor	politeness
woodworker	craftsman	skilled_worker	carpenter
prognosis	prediction	statement	weather_forecast
insurance	security	assets	hazard_insurance
breach_of_contract	breach	failure	breach_of_warranty
executive	administrator	head	minister
plant	building_complex	structure	factory
sexual_intercourse	sexual_activity	bodily_process	fuck
brush	implement	instrumentality	shaving_brush
industry	commercial_enterprise	enterprise	entertainment_industry
nonexistence	nonbeing	state	impossibility
protest	resistance	group_action	boycott
journey	travel	motion	voyage
quality	attribute	abstraction	nature
caterpillar	larva	animal	bollworm
sound	happening	event	peal