squash	vine	vascular_plant	pumpkin
hairdo	hair	body_covering	haircut
pictorial_representation	representation	activity	photography
organization	social_group	group	institution
escape	running_away	act	exodus
association	organization	social_group	league
extremity	external_body_part	body_part	limb
angular_distance	angle	space	latitude
science	discipline	knowledge_domain	psychology
vascular_plant	plant	organism	herb
topographic_point	point	location	junction
geological_formation	object	physical_entity	shore
place_of_worship	building	structure	mosque
ravine	valley	natural_depression	canyon
kin	social_group	group	folks
nymphalid	butterfly	lepidopterous_insect	peacock
internal_organ	organ	body_part	stomach
connective_tissue	animal_tissue	tissue	marrow
public_transport	conveyance	instrumentality	train
photographic_equipment	equipment	instrumentality	camera
military_action	group_action	act	war
coloring_material	material	substance	pigment
bulge	projection	convex_shape	nub
tubular_cavity	cavity	structure	throat
code	coding_system	writing	software
cost	outgo	transferred_property	payment
angiosperm	spermatophyte	vascular_plant	flower
demonstration	visual_communication	communication	display
fiction	literary_composition	writing	story
commercial_enterprise	enterprise	organization	industry
spiritual_leader	leader	person	rabbi
covering_material	building_material	artifact	plaster
marital_status	legal_status	status	marriage
metallic_element	chemical_element	substance	aluminum
edible_fruit	fruit	reproductive_structure	apple
horizontal_surface	surface	artifact	floor
spouse	domestic_partner	person	husband
domestic_fowl	gallinaceous_bird	bird	turkey
medium_of_exchange	standard	system_of_measurement	money
dance_step	locomotion	motion	moonwalk
emotional_state	emotion	feeling	happiness
garment	clothing	consumer_goods	laundry
hour	clock_time	reading	sunset
concession	agreement	speech_act	stipulation
flock	animal_group	biological_group	gaggle
fur	animal_skin	animal_product	raccoon
female_offspring	child	offspring	daughter
management	social_control	group_action	administration
grass	gramineous_plant	herb	meadowgrass
citrus	edible_fruit	fruit	orange
explosive_device	device	instrumentality	bomb
document	writing	written_communication	report
administrative_district	district	region	reservation
ocean_trip	water_travel	travel	cruise
ovum	gamete	reproductive_cell	egg
mathematical_statement	statement	message	formula
big_cat	feline	carnivore	jaguar
sexual_intercourse	sexual_activity	bodily_process	fuck
integer	number	definite_quantity	digit
contest	social_event	event	tournament
time_period	fundamental_quantity	measure	century
headdress	clothing	consumer_goods	hat
thrall	bond_servant	slave	serf
beam	light	actinic_radiation	sunbeam
site	tract	geographical_area	cemetery
unpleasant_person	unwelcome_person	person	scold
life	living_thing	whole	wildlife
affair	social_event	event	celebration
religious	religious_person	person	monk
kitchen_appliance	home_appliance	appliance	stove
adult	person	causal_agent	man
handwear	clothing	consumer_goods	muff
contact_sport	sport	diversion	football
natural_science	science	discipline	physics
time_period	fundamental_quantity	measure	morning
attire	clothing	consumer_goods	costume
great_ape	anthropoid_ape	ape	gorilla
hymenopterous_insect	insect	arthropod	bee
court_game	athletic_game	game	tennis
classical_music	music_genre	expressive_style	opera
wind	weather	atmospheric_phenomenon	breeze
skin_diving	swimming	water_sport	snorkeling
philosophy	humanistic_discipline	discipline	logic
artwork	visual_communication	communication	drawing
plant	building_complex	structure	factory
army_unit	military_unit	unit	troop
woodworker	craftsman	skilled_worker	carpenter
hour	clock_time	reading	noon
skeletal_structure	structure	body_part	girdle
celestial_body	natural_object	whole	planet
running_away	act	event	elopement
protest	resistance	group_action	boycott
concession	contract	written_agreement	franchise
atmospheric_phenomenon	physical_phenomenon	natural_phenomenon	weather
national	person	causal_agent	citizen
financial_condition	condition	state	wealth
film_industry	industry	commercial_enterprise	Bollywood
physical_property	property	attribute	weight
transferred_property	possession	relation	loss
body	social_group	group	college
imaginary_place	imagination	creativity	spirit_world
computer_architecture	specification	description	neural_network
dealer	firm	business	car_dealer
tract	geographical_area	region	breeding_ground
circumstance	information	cognition	mitigating_circumstance
watch	timepiece	measuring_instrument	pocket_watch
device	instrumentality	artifact	breathing_device
childs_game	game	activity	musical_chairs
school	educational_institution	institution	public_school
company	institution	organization	drug_company
prognosis	prediction	statement	weather_forecast
fish	aquatic_vertebrate	vertebrate	bony_fish
election	vote	group_action	general_election
score	number	definite_quantity	football_score
table_game	game	activity	table_tennis
bicycle	wheeled_vehicle	container	mountain_bike
aorta	artery	blood_vessel	abdominal_aorta
forced_landing	aircraft_landing	landing	crash_landing
use_immunity	exemption	release	transactional_immunity
torture	persecution	maltreatment	sleep_deprivation
anchor	hook	mechanical_device	mushroom_anchor
brush	implement	instrumentality	shaving_brush
public_knowledge	cognition	psychological_feature	common_knowledge
battleship	warship	military_vehicle	pocket_battleship
armor	protective_covering	covering	body_armor
pipe	tube	conduit	steam_line
memory_image	image	representation	memory_picture
insurance	security	assets	hazard_insurance
rat	rodent	placental	brown_rat
statement	commercial_document	document	income_statement
tibialis	skeletal_muscle	muscle	tibialis_anticus
scheme	plan_of_action	plan	waiting_game
lens	optical_device	device	camera_lens
grass	gramineous_plant	herb	broom_grass
theater	building	structure	music_hall
flight	trip	journey	connecting_flight
nerve_cell	somatic_cell	cell	brain_cell
boat	vessel	craft	police_boat
circuit_board	printed_circuit	computer_circuit	PC_board
bedroom	room	area	motel_room
bathing	diversion	activity	sea_bathing
industry	commercial_enterprise	enterprise	entertainment_industry
skeletal_muscle	muscle	contractile_organ	temporalis_muscle
sucker	catostomid	cypriniform_fish	buffalo_fish
poisonous_plant	plant	organism	poison_ash
push_button	switch	control	mouse_button
measuring_instrument	instrument	device	static_tube
metric_space	mathematical_space	set	Euclidean_space
trip	journey	travel	round_trip
heating_system	utility	facility	panel_heating